0, -2, -2, -2, -2, 0
-2, -2, -2, -2, -2, -2
2, 2, 2, 2, 2, 2
2, 2, 2, 2, 2, 2
2, 2, 2, 2, 2, 2
2, 2, n, n, 2, 2
1, 1, n, n, 1, 1
1, 1, 1, 1, 1, 1
1, 1, 1, 1, 1, 1
1, 1, 1, 1, 1, 1
-1, -1, -1, -1, -1, -1
0, -1, -1, -1, -1, 0